1111111111
100P000001
1111011111
1000000001

1000C00001
1000000C01
1000000E01
1111111111