1111111111111111111111
10P000000000C000000C01
1000000000001000000001
1111100000001000011101
1000000000C00000000001
10C0100000000000E00001
1111111111111111111111